1 1
.

5 8
########
#..#...#
####.#.#
#..#...#
########
